111111111111111111111111111111111111111111111111111111111111
1000000000000000000000000000000000000000000000000000000000P1
1000000000000000000000000000000000000000000000000000000000P1
1000000000000000000000000000000000000000000000000000000000P1
10000000000000000000000000000000000000m0000000000000000000P1
111111111111111111111111111100001111111111111111111111111111
100000000000000000000000000000000000000000000000000000000001
100000000000000000000000000000000000000000000000000000000001
100000000000000000000000000000m00000000000000000000000000001
100000000000000000011111111111111111111110000000000000000001
100000000000000000000000000000000000000000000000000000000001
100000000000000000000000000000000000000000000000000000000001
100000000000000010000000000000000000000000010000000000000001
100000000000000010000000000000000000000000010000000000000001
100000000000000010000000000000000000000000010000000000000001
100000000000000011111111110000000011111111110000000000000001
100000000000000000000000000000000000000000000000000000000001
100000000000000000000000000000000000000000000000000000000001
100000000000000000000000000011110000000000000000000000000001
100000000000000000000000000011110000000000000000000000000001
100000000000000000000000000011110000000000000000000000000001
100000000000000011111111111111111111111111110000000000000001
100000000000000000000000000000000000000000000000000000000001
100000000000000000000000000000000000000000000000000000000001
100000100000000000000000000000000000000000000000000001000001
100000100000000000000000000000000000000000000000000001000001
100000100000000000000000000000000000000000000000000001000001
111111111111111111100000000000000000000001111111111111111111
100000000000000000000000000000000000000000000000000000000001
100000000000000000000000001111111100000000000000000000000001
100000000000000000000000000000000000000000000000000000000001
10000000000000000000000000000000000000m000000000000000000001
100000000000000000111111111111111111111111000000000000000001
100000000000000000000000000000000000000000000000000000000001
100000000000000m000000000000000000000000m0000000000000000001
100000000001111111110000000000000000000011111111100000000001
100000000000000000000000000000000000000000000000000000000001
1m000000000000000000000000000000000000000000000000000m000001
111111111100000000000000000000000000000000000000001111111111
100000000000000000000000000000000000000000000000000000000001
10000000000000000000000000m000000000000000000000000000000001
100000000001111111111111111111111111111111111111100000000001
100000000000000000000000000000000000000000000000000000000001
100m00000000000000000000000G0000000000000000000m000000000001
111111111111111111111111111111111111111111111111111111111111